[console_scripts]
osism = osism.main:main

[osism.commands]
apply = osism.commands.apply:Run
bifrost = osism.commands.bifrost:Run
bifrost deploy = osism.commands.bifrost:Deploy
compose = osism.commands.compose:Run
console = osism.commands.console:Run
container = osism.commands.container:Run
netbox = osism.commands.netbox:Run
netbox check = osism.commands.netbox:Check
netbox connect = osism.commands.netbox:Connect
netbox deploy = osism.commands.netbox:Deploy
netbox diff = osism.commands.netbox:Diff
netbox disable = osism.commands.netbox:Disable
netbox generate = osism.commands.netbox:Generate
netbox import = osism.commands.netbox:Import
netbox init = osism.commands.netbox:Init
netbox manage = osism.commands.netbox:Manage
netbox ping = osism.commands.netbox:Ping
netbox sync = osism.commands.netbox:Sync
netbox sync bifrost = osism.commands.netbox:Bifrost
netbox sync ironic = osism.commands.netbox:Ironic
reconciler = osism.commands.reconciler:Run
reconciler sync = osism.commands.reconciler:Sync
revoke = osism.commands.revoke:Run
service = osism.commands.service:Run
status = osism.commands.status:Run
wait = osism.commands.wait:Run
worker = osism.commands.worker:Run
